shd: hzh hcz sch rnf
pmk: dpr
hcf: sjt stk plv fjx
kkp: ggq fqq
fhc: mvh
rrx: jjj qht
bhc: grq qmx cdr
kzf: mnc ksm nzj gtt pqq
qhk: hmm jxg qtb
hzp: zrx hst
lss: kzl dzx tjb
jvh: vfj
cnz: tlp
lsx: pbb gsg
jnq: mjk chg dmq dbb
xrf: znm
dpj: zgl dpz flt rfr
ntl: kfg dnm
qhz: fdl
bkv: ptn ldn nlg nch glp
mhg: ngq jjq fvr
fmt: vsm xtb mdj qst
bhl: nmk plc
cqn: dpz
mgn: frj cql
sqq: phd ctg zlx ftn
zvv: xnj
bbn: bmb dmb
sfj: fnb
qkg: jck vzz xlx vrt
dtj: fxl fbf
vgn: qbk qmx
ssd: mhq blr cqz mxt
tzb: nhx kps zjj mnj
rlm: txr tfz xkj
rnv: lbm hbp
lsb: qtb tvp zpg zlr
hrn: bjf xpd
rhr: rlh lpk xhz kvd
smm: nhp tpg nth vpp pbf
khp: hcf lbx
bjr: nxs lvq
lbx: srg
hpd: pxb xvf
lkx: jnx rml
tmz: lcs xhj gcl
dfq: pkk
fxh: kqn ztl qmk kqx sbh
mdd: jnz bqp xht mnv
grg: qcn bmg vdm hcm
bdx: pzb
fcq: blb
bnn: dlz tjq
bjb: bjs
nnd: sxl kgd
ght: pkr
jdr: fnt
xct: vzl
tnl: ljh cqm cdr
csz: hfk hpv
vfv: vck
hdz: khm tdv lgk
lmm: tdv
mpd: tvp vml ttn
vmd: mnj nqc
txl: jfr
pqj: xnh vzl
qbk: tpn kdz
ckk: gqt ggq
gxv: sbv vjm cxd
fnt: kcq
kzk: mcr pnh gnn mcs
jjd: rkc dtj hqr fqr
bdr: ljv mfn xff
spj: ngq
jpb: qgg
fbp: tsc xld ncq qrl
lzd: rvf xlx
mrb: jnz brz
vfr: vtj
qpt: knd mgl
gbt: pzb szl
pnb: qgq zvx qjz
kgn: fsl jnx fnc
ghl: blr lnp tgj xvf
grq: nfm
rts: lmm
zmv: rhl
sjt: hxz blb
tfz: ttd stk nfb
zdc: bdx nph ccn
zzl: spv
mtm: khv jqr jpn
dtk: pqq qmx
jkb: flg gfh dgv rjm
scm: ngq rrz
mxb: sfg kdz
hzt: zqs xkq blm hlf
kxq: gnl cmn lmd ztq xrp
rqd: phd bhl bjt knn
dzf: kdz
ktd: flg
rtl: gfx hxj cbl
dbd: cnz pkn mvq lft
cff: bps xnr
hqr: lqt nlg mdl
dxf: pcx szp mgj
mjq: lsr smh tpm pqx
ljv: cqr
lcs: xnr fjt
hnh: jgr ghk hfk
xdt: pmk lfc hvl
pmr: skm
tfp: lsj npv pdf
lmx: xht xnn
sfk: pkp xnr ghl xdh
pqq: hht
jjr: kzc
tjv: pbk jzp bng pbf
jbz: qvq vfj nfc
gfh: zfr dqt
vzm: vlh vrt mkg
xxl: kqj lqg
hkn: hxh
xdh: jdl nph
ncz: rnv kdd rls
dgk: txr vkx mvq frp
txr: chr ftv
qcq: hzd lpm gvr
tgv: ttm
tpb: fmf krx pvg
hfn: lxr jfx xnb kks fgl
vpp: bgh
jrt: rcl xds fqc bqh
drj: vtj kps frj
fdx: nmd scg
kth: kzc cqr
qqs: jxm vmg xdf
jkc: hbg xlt crz skm
lcb: xpq vkq
shs: bps
rtk: vzl
vrq: flg bbq grl nth
cld: plf klh jkj
lzh: txl
xxq: zmv xjb vkr
sbn: ncz lft pbk nxb
vbg: tgv kpg mpg vdj pfl
hvm: sgr htb tnk ztd
sxc: hpx mxb tjb
shc: zxp qvm
xkj: dfm bjs ptl
tsl: pbd xxl
gfn: qzn mkk lmf
bzn: xvv mfv lsr
qrh: jsl
vls: vrr vzm qgg pqz jjg ksm
xfn: zvv frp fhl khb
rxq: cjg spb dqm
prz: sqb sxz xzb xrb
hdt: dfg dmg jdj spn
xnz: shc
bhf: nxs lkj
cfp: skb
pzp: smh jtd
sfc: fjv
rtn: lbl mpg ljd dzp
rpb: hrk
fmz: lkl mhq rpx scp
cqz: lmx sqh
mvv: bcv zfh nmd
txn: ckk
qqz: cqj lzx
tpm: lxc rrz
bbm: vfh qgg
qbz: vzj fdg cgk msn
vpl: hpl lfp jxv srf zlx nmk
dck: lxg bvt sth
ddb: ntx lmf jbz nbp
jqq: lbx zxp lhh mjk
vdj: zrh gfn pzp jfj vsc
stz: gnv rfx vfv hzs njs jts scx
cfn: vth
zcq: jzf
tzn: fvv xpt
kdr: glp lmf
kbf: zvq sdf
tsg: nzg
pds: qhh jbp klz stv
cnl: nfm zvx cdr mfm
fds: pmp dzl smm
zrh: brl tsc dmg
pdf: hxc
zrm: ztl lkj szl xct
ddh: tsl vlh cdg kdm bsl
xrp: ngq
jpq: lxg frj kns npk
hzb: ghl knc rdr mjg
cbb: ndf
zbq: thx ptv
xjb: kns zkb
jnv: vnz rrc lrr fcd
zjj: chg ftn pfd bcv
jqc: jjj ftv pdq glp pzk drm
hzz: kpk vrz vlf qhk
jqr: csp dxx llt qct
qgq: cqj nfm rzc kqd nmq
lrt: bjs tgv bqh hfv xcx
vbz: vjs mmt hbp
hgj: vlf bdr kkf xpt dbc
brn: hcr mtm nlj rbj
bgp: qmr jkj
gmn: dkf pdm jbp
kkh: khb
sxz: gqt
vsv: cqj
sjd: mpd pdl rpx ckc hnk
bkf: skb
cll: tpp vzz kqn qjp
rcl: rml
qst: cps lbh
cvc: xpq frb dmb scm
kzd: cml pnx
tpg: bhl qhl bng
dfj: gtt bjh xdt tpn
dnn: vpm xjj
pvc: kkp txl mcr bkz qbg
vkq: xrp
pjb: nxs cqz fcj kfg
qtm: pcp bxb
prc: jdr ljv
mhc: nzb kdm sbd pmk
rrc: kkf grp
zhs: qzh hmj qst pbd qzg
kks: bbq knn
xlt: sfc fpz
plh: dkt ndg rnf khd
jhg: zkx ntx
szl: qbg
grb: txr kpg jxv jsm
pkb: trr
blf: vkg
kvk: scg rbj vbh dqf ghb
lxg: hpl
dpr: stv
sjh: vfr bxb rml
xjf: bjt khp tdk fxp
vvs: rcf zfr rqh
nfp: ncq nrf
gqh: sfj kkh sqs pcp
pzk: pkn gng fvc
hsm: blf lxc rkc tgv
ghp: ftv
vfh: pqz jzf
czb: gcl xhd
tgx: cfn szp zfh fsl
hnb: bvx lfh cxd xct kth
dhc: zzl lhh drm
rqh: tlp hrn fbv
xnh: xdl ntv
jql: jzp gbp hhs
kpq: zlr
dkf: skl
mjg: ggq pkp
tnn: qjz
mkf: hpl
jzc: vnt bfb qsd
rnf: nfc
dxv: fsl fxf dtp xrd
vqh: ttq bnf
kjn: xdt phx ntl jzv
nzm: npz cnz mnj nfz
brd: gvr tfv qrf jdr lqp
ftn: vpm
gfx: dkb hmp
xmk: grp ptv
cqm: npv
rnl: fbb kgp qzn
zgm: kzc
mxt: fzk
qhl: mnn zkb
gns: zhb xnj scg
ntn: vms bjb msn mjl
zvq: bfn
zzf: cbl
ncq: tfd fxf
qjg: hcx
vss: mjg jlr mvt
cdg: rjj
pcr: khr bjf vkr
smf: snr fdx tdv npm
vml: kcq xcl
svz: vph
lcc: ptl drl
hxq: gjg
fsq: knd ccf kpp
vlf: skl dzf
qpg: gbp zfh
rzg: qhc mbg hlx
dht: jzf xht jdr bnv
ntv: thx hst
sbd: bch
fqp: tdk
jxv: rbj
nhv: ngc rjb
drf: ntg jpk ssn
sgp: gdp mfn zcd zkc
prl: dpr kjs ghz jpr
khx: tqc jtb kmq
lng: gxn vph jfr ngc
szx: fds frb hrt xxq bgv tbl
hvv: tsf gzc
pkr: pbb
rcf: rrx drt jvh
gvn: tfd kbf xjj qpt
dfl: sbv gpx jxg jgx mbk
qrf: fsb
jkm: jmn nhp rnl tbd
pqn: nzb zqn
qsq: fzl qsj rnl hpl
nfk: gxv jzf
pcz: zhd fqm fzk zkc
dmq: tbl vbh
jvc: dmg mbg jql qvt
zfp: hlt jtf fnb bbt
fqq: nxs
nsn: sbh nmq
hxz: lxg qvm
npz: kkh
vtr: hmp dnc dtk tnn kqm
fqm: pxb nxs
hbp: zkx
qtx: rts bxb glt zvr
nrc: sdf blf
qrl: lmd
lll: nfc vft blm
rvg: qhz sbv
mvt: xrf
zkb: sfc ptn fpz
sfl: ztq kgc
ghb: hvt
vph: mvc
vks: kvp rvg pfr jlr qkl
xbs: fnc brt plc mfv
ctg: khm hmh szp
dnk: bfn lbl frp
nfj: tdk rtt hcc mqc
kpk: xdl
xvt: fqr hlx mgl fqc
lxc: jsl clc
ptl: ftn
ppv: fpf ffq zhx cml hxh
qlq: mfm
kdb: qjb
hhs: sdf
gpg: lzx gdp qsm cjg
nph: tfj
nzf: nnn pqn kzd
dbl: chk nxl pxl
plv: llq xfk
lql: ghp vkq ngd tmf
cml: zrx
jsm: qrh xnj hnh
ljd: qxp vqh
pcj: hkn mbj tsb lsj
gsg: jxz
lkl: fhc jjr rjj
mjk: dtp bpg jnx
xsr: kdr jrn nzq lkx qpg
fzf: znm xfq
pns: hzt nst pdq tcn
flt: zjq lbh qkf cxd
lfh: vph nzb rcj
kpp: kns dmr vzd
zbb: vvp kvz jmn rls
gbn: dvr tsf
hxl: pfd fnx
lsp: zkd clc pqp kng gxg
kll: jfk ldz mhx qck
qmx: hzd
vjm: gnn
sfg: xqf dkf xct
mnj: nqc
cpt: cff hzd krb kdz
xdv: xff nxt cfp pxh qjp
xrz: xhz jjj nfb nzq
knd: npz tdv
pnx: qtl gzc
mkk: xdd lmm
fkb: tlp xld frm fqf
zcr: zfd fsb xtb tfj kqj
sch: nmk xbz vlj
zsb: zkm gbt tsl crf
tpr: hhn jkd
flc: stv
xtb: znm
flq: rht skm
zrg: rcj fjt
jrc: vxt xhz lhh
gjq: ltg dpz
jtf: qzn cql
bcf: vnt rfp sfl zkd ljd
pcq: hkr
rcp: jrz vft qbf
nxt: qmr ttz kkp vss gjq
nqb: rdv pxh blr
jqs: qzf pbf pmq hxp
hmj: mfn nzg dqm kqd
sbl: kbd jrz
nlg: mgj
zkt: bmz jnx fds zzl
mkg: cdg
qlr: bgv xmc mfv xdd
sgs: xxl nsf vlh dvr
xfk: hvt mgh
gsj: mgk dgv lmm
mbk: qjz sdb sbh
fbq: hvj xfd qcn fqm znq
zhx: ghl
qtn: vgs blr jtb
zdf: hpd zcd nfk zzf
frt: knn gjb fdj
clc: ktd
qfs: fqr
zqn: kqn xnr xfq
tzq: msr nsk frm bmb
kss: khp mkf xvv fjk pjs
dsk: zrx hnk dtk fzf
xzc: qbk hmp ctm
cdd: fsb jck
tpl: tlk xtj sqz fst
rjr: ngk czb crf zgs
gcl: jfk
hsb: vmd csp kdb
fdl: lqg
nxl: gjq tnk gnv fzf gtf cfp jgx
llt: lhh
nsz: gmz fdr gxr vth
jsd: hhn vrh fpz
mgh: hhs
ppm: ggb vxt fgn cbq
dzx: jfb
pqp: tmf mkk bsx
lfc: hbz gtt pqn
ntc: rht fdg
qkp: nbp gnl rdc
fvr: crz bpq
hvj: sxz
ssj: chg mxs
jtt: zfd
lpk: hlx
dzh: btc nkm
cfg: dkb vck
vft: zvs
fdb: vms xjb hrn
hcc: khr pcq gnk
xxt: tjv fbf xld mxs
fsl: ghk
pmp: blg fqf bjb
bpx: hzh gpp khr vvs
zpm: tnn mlz djk pdf
tjb: rqt tpt bvx
hbb: rjp rht nfc
ldg: jpn gns vkg vxt
pfl: dqt rcl jns
xvv: fdb
fgl: ckl jbs kfq fqc csr
ctz: prc nhg fvh hbz
mph: xgc sgl jtt rmg
csp: kbf
vcf: jtd fch chg jxv xnb
kmq: rdv mnv lnp
vbl: bdr pbd pdm
hhm: jzv qjz lfd
tjq: mdl kfq
trt: vds jkj
ldn: mxs
vjs: zlx gpp
kqx: kqj fts xcb
kps: gfh
ztq: llf ntx
dfg: cxc tvg qrh rkx rnv
nlf: ntv tzn
xcl: bps bst
fqz: hxz jbs sjh bpq
pff: msr rtv xcd vfr
dnm: qsm
rst: bml grq trr tsf nrg
nst: lfp fst zhf
qhh: sgr
xgx: ghz vck sxc tpk gss
fzl: xpq
fmg: jsd hfk rxs ttq zvq dmq
msn: mnj fjv bfb
dzb: gjn lrs ztd tqc
nlt: tsg vlt zvx bhc
tvg: srg nfb drj zjd
bml: jts fdl sdh
rsv: mdl
sfz: snc xnz nrc
jnf: dkt llq nfb fgn
vvr: prc mxt gtz cxb trt smp tfp mcd
dct: srf vvh fvr llq
sbh: ccn
nbp: llf nzq
fjp: sdh svz pdf grp
snc: nnd kns crz vms dxx sqs
ksm: mvc
xrd: pbb
brt: kdb
tfj: zvx
tcn: ccz ntx
jfx: gxr hnh mtn
xds: zkd
xcf: nfz khm
fvv: rdj
cxd: mfm
fmj: ssh fnx vbh
bmz: nxb hqc cgk
dnc: vsm rqt shs mxb gdt
qdh: dqt pbk mvq lbx
kns: kgd
qpf: jxz
zqs: rml ptn
tbl: jpp
pdq: qrh jlz
qtb: sdb qjp
tcv: vvp vmb chg
qct: sxm cfn brj
fqf: zkp
xsj: kpk fvv fmf tpt mkg
glt: rkx
vzj: drl qpf
plf: fvv kdh
gxg: rtv glt bsh
xhj: qck kqd lng
dtp: kgc
znq: trr qkl
gch: ptv ndf
rth: scx zfd kdm fnh mhq
xjg: hcz cqv qsd qht
tpn: nzg djk
ttz: vgs cml gdp jbp
dlv: rdj fjp
xnl: fbb qvm
gfr: lbm rjp
qbc: tpp lqg kzc cbl
vkr: ggb npz rqk
ndd: chk qkl mcs bhc
qkf: jsh nxs
qrz: hbg jlz qpg
jfb: kvl jpb
sjs: fhc chk jxg vzz
ntg: jdr qtl
thg: zkd gjg
vxm: jnk jnx hxq
cbq: dck jxz vkv
qdf: fjk zmk sjt ctb
fcd: jtb xlb hst qhh gjn
crg: bjn rzc jpk skl xfq
jmn: jrz
tbq: kdh mlz vds
xgc: xzb mfm jtt
pmz: fdr qtm vlj
pkk: jsl khv
dxh: hmm ksm cdd ltg
tkj: lmd pbf rlh
cjr: tdf ssb nhv rrc dqm
fvc: gnc rsv
lxv: msg zkx vzd dcm
bvx: znm sqb
qmr: zcq
xqh: nkm tsc
tpk: kvp
zkz: tlk fnc zlx
chk: nzb bps
chh: dnk xvt brl
vxr: rng ktm bdx xlx
gbp: fjv
hdn: hmm vsb xrf gdp
hbf: nfz sdf csk scg
cqr: mvc
zhm: llf msr xdd jxz
chr: vlj
zdr: lvh ddg xvf
zhb: xrd bsx jpn
tjx: mkg bqd
zfd: fzk
xhd: pkb grp hcm
zcd: nfm bqd jjr
mlz: tpb ljh
fts: qjg bkf sbh
fvx: nmp kkf gtj khx
bpg: hqc
nfz: mmt vkg vvp phd
xzx: hfp xtj frb hsm
hgz: nhx nxb vzj tcv
nxf: ndf
qtc: qqs blr rfr gtj tbq
zlm: bvt nzc fnc
hpl: brt
mqc: dnk lxg qfs dkt
smr: ljg qvm fpz xfk kzg mqq
lvc: hxj bjr
hvt: kkh
rbg: tdf gnv
qsv: bqd vmp zfd qtn ddg
jtd: bpg kbf
vdm: nfm
nvg: hnk vfj djk mrb jpb
snb: jnk qpf
sqz: frj nxb rkc jvh
qxp: bxb
hcd: frt kgx xrd hvt
lvm: bmb sbl dhc kks
crf: drf tpb pdf
hcm: mnc vzz
qlt: npv jpb fhc
bnv: hmp
gpl: gvr rng pzb
nml: xfd vds
hgs: qkf fvh qmx
zbl: xht fzk lmg hmp
ptp: kps npk knz kvt
mzv: rfp jrn btz
nzj: rqz hvv xqf
hkx: pkh hfp qlc
kjk: pkp kdm gnn
bnf: zvs
mcr: pdm
jpr: vmm kkp hvv gzk
bch: npv gch nzb
zhl: prc gxn nvp hst ctz kpq
sdx: vmg
ftx: xnh zlr pqz kxs zkg cmh
rhl: mxs
vfz: fjx ctb cmn shr
hxj: ndf
ttv: pbf vkb rkc xrp qsd
lzx: dkf
gxr: fzl
nvj: qzz hml hbp fsl
djk: stv
hml: vbz xvs jzp
mnv: tgj bkf
nch: kdb vkb kgn
vnh: mkn zkg bqp hnk
xkx: vbl ljv zjq
qcd: hzp skv xdf czb
khd: kks xpq cbq
tsj: rfj rxs xlt ctb
dlj: ttn tpk kvp lzx
hkr: qjb
jdl: ltg sfg
rmg: nvv ftr tks mxt
vvg: qjg cqm hhm jfr
mlt: ckc trt mvt hrk
rnb: sxl tbc fdg
zjd: rsv vrh zvv kgc
vqx: nhv hvj sdx tgj
fbv: pfd tdv hxz
lbh: vfh
sqs: srf
nsk: hzh gfh
dmz: kxs rlz ztd
rgm: rqk bbn zkz dlz
hmh: vfj ssh
qtg: lrr pmk cjg cqz
srg: fjx brj
xlb: nzg mfm nxf qcq mks xmk
ldz: nsf vqx
sqh: jbz vmp
bsm: zpg hmp fmf
jls: lzh vsv jtb
hct: cbb thj gzc grq
rvl: jvn bhf lrr cdr
hrt: kfx dkt
pbr: tqc nvp xhd tjb
jcc: cld kth jxm xpt sbv
chq: tpm lmf ksh bjb qpt
qsm: lvc
zpg: tnk ccn
cpf: gtf qlq bps
xgt: txr vhv dfm csz mzv
qvr: mgn rcp kdd xds blm
fhn: ghp ttd zbk mdv vkq
mqq: qts rbt xrp
qsh: ctb rml dqf mkf kdd
hmv: pkr fjv
xns: xcx ktd xvs fqb
bms: plf mvt nrh
crb: tjx hgs rpb vgn lvq
zhd: hkn lpm jxg
smp: cdd zhx
lrh: zhd dlv pxh
bjn: jpk
pdh: vft xfk zvv qpf
bmg: jkj mrb flc
gnk: hnh sfj fxf
bqh: khb
jts: dvr tnn dkb
frm: knz
qcx: qtb xnr mvh
xsk: gnx tnk kcq klh pdf
fmv: xfd tsf rxq
qvt: lph sdf ljd
bjh: ckc svz
cjj: gdt ztl rvf vks hrk
ktb: cfg kzd kqn
fxz: rht fpz bzn jnk
frj: dnn
xrg: bgv zcc drj tcn
kvt: dsh rhl mnn
gbs: kxs jtt pds pqq
fcj: ntt rbg nxf rdr
pkt: vlh tht zcq zzf
xtj: jzp
ssn: hxj
lvn: vqh qsj fpz qpf
jxm: lgj
hzs: rzc lmk
rgs: fdl tmz xcl sjs
nbx: svz shs tjx mjg
vxt: fjx
bdt: zjd gnl pmp
xtd: jhv cql zxp kbd
kxb: bgp sdx dlv cps
fvh: xdf jzv
blb: vpm
ljg: png plv rhl fqp dkt zsx
sfs: pqj sdx zbq kpq
xzb: tpk jfr xrf
lxr: bbq dmr zkp fhl
gzp: rcl knd spj hxq
gvg: scg bgh chr nmd
fps: hfp zlm jkb scm
tsb: shv phj
skh: pkb qqs hpx gnx
mmx: hbz ktm zhd rdv
gjb: pmr sxm
rzx: mvv qvq dfq fxf
tjc: mxs xtj
kfs: qjz shs qhk nml
bkz: nfm
fgn: zvs hsb
nvd: qmr kjk kqj txn xpt
ffk: kmd pcr shc
msr: qfs
jzh: bnn jnp tdk hfh
nxd: kcx
csr: fqc dlz
zkc: dvr ghz
ggm: hjb xtj
cqv: rls xnj zvs
qjh: lmg hxj rpx zpm
brl: tfd vmb
rhk: hlx snb zmv fnx
nzc: cnz ghp
llq: vfr
dms: rkm rpb trr
hxp: ssj rtt bsh
zgs: hrk zlr fmf
tht: pnx mbj bqd
mrk: mcs xkx xqf vml tnl
ffq: spl gfx
fcn: nth pfl sxm xnz
kdd: jrz
pqh: hbn sfl btz lcc
nzx: bkz jls npv mcd pbd
hmf: dvl mkn tdf cnx
zhf: ght jjj
drm: rcf cbq
lfp: kmd
hhn: fsl zkx
rzq: qdf jsm ttq sbl fmj
ftv: ssh
zqj: shv hhm jfb qkl
ksh: gnc mxs fbf
mhx: sdb rtk
zvr: lsx qxp fcq
sjb: mgn kfq bqh xbz
fqb: jhv plc
cxc: smz hkx gng
jlr: rdj gss mkg
xhr: brz rng nvv vbl
vln: tdf sgr
gzk: hkn znm gch
rjx: bkz tpp dbl mch
xnv: rrz nhx lft
cnx: ktm xlz
gjg: ggb
pjs: mnn qrl
vhv: dqt dfm rbj
vrr: mvc skb bjn hvj
ztl: sqb nxd
lkg: rrz bgh sxl
xfp: zzf vfv lrh gtz
ckc: rpx jfk
vrz: nvf spb gnv vjm
szp: vmd
kdh: pxb tvp
nmp: tpb ddg nxf rtk
brz: qbk
rfx: dkf spb
ncd: vlj pzk gbp spv
dcm: knn
php: ntv hxc klz
qvq: fxl
lmd: bbq
bvt: hfp jxz
bqk: fqc phd srf bcf
ljh: xnr htr
kng: bjj gnc vkv xcx
rkx: hkr tbc
bjj: hzh fqb stk qkp pzk
gtj: cqm gjn sqb
kqv: bcr xnl sfz hbp
nbg: zdr jpb qrf jnv
fxf: jzp
ssb: dnm nqb vnz nnn
jgr: hxq mgj
dzp: lmd
zjq: ttn vsv
bfb: kmd
pgr: mks hht xzc cqn xvf ttn
jxz: vpm
bcv: hlx ctg jrz bvt
vbh: mgh pkh
rkb: rht hfk sth
phj: fmf zgm
bgv: fkn hbg jql
tbf: cjr nrn ngc xct
thb: hhn tbc tpr gxr
tlk: llt qsd hrn xpd
qrb: kzc rzc rtl sbd
hlt: hbb nmd nzc
cls: qtm hmv jsd png lll hqc
nxn: nsk gfr lkg kvz bjd
vzl: gnn
psh: vxm jmn vvp
jbs: vkv jhg
pxg: gzc ghz nvp zbq
bbt: pkh bcv qrh fcq
jfj: fnb rxs
nrg: hmp svz hxj
rnk: qlt fzk pkp zhd
bpq: ccf
qbf: clc qsj nqc
xnn: qhz hbz zkm
pbh: hcz kgp dtj vkq
xkt: dzx zrx vdm ldz txl kxs
hbn: fqr pcq xmc
rdc: blf xrd thg
mjl: rjm jhv mnn
mch: klh kqd qlq
xcb: hgs qrf
smh: gpp hpl
pzs: pdm bbm fzk fnt
cmn: phd kfx hhs csr
ldm: ldn fnb zqs kmd
bng: nxb rkb
dgv: msg bfn gjg
tbd: csk
xjj: glp
pxl: bjh vsm zrx xcb
jrn: tkj vkg vfj
tvp: xht hmm
lnp: lvq gpx cbl
fxp: jpp dmr
tdx: scp rqz tfj dqm bsm zvx
ndg: gbp jlz cnz
shv: gxn
dlz: flq
fbb: nhx
pkh: zfr xdd hqc
rlq: bgp fmt vln
bsl: kcx fqq
dmg: sdf fxp
btc: ktd hkr qxp
xfd: rcj
snr: rqk
jjq: npm blb
rjj: gxn lgj
rjm: zbk qtm fhl lsx
qzf: dgt fch nfp khr
shr: hlf bjt cft
cdr: rvf
cmj: kdz
tmf: vms ftn
fjk: vkx bnn vnt qhc
qkl: kcq
blm: xnb
krx: cpf vph
skv: tvp
gtf: fnt
thx: zkm
vvh: vfj nzq dck
vqp: pbd zrg
dqt: npm
mcd: kcx gml
pvp: ntc rts jnp bjs
xlz: shv bst
rfj: ffk rnb
lfd: qjp pvg
qdk: rdv tmk vnz qcn
zkg: vjm mks
pmq: cft fst kdr
gnl: hmv zkb
dxx: ldn zxp
rfr: lmx nzf vln
zgl: rpb spb ppv pxh
hvk: pcq sxl bpg hdz
vrh: pmr tsc
vsz: jjq khb xcd
lrs: pqj vck cdr
msg: vth
scp: vgs mdj
cqq: fsb
png: qlc lsx
xrb: skv ppv ktb
zmk: kvz pcx lgk
kzr: dcd cjg dms cnx
prt: msr chh xnz xcx
qzq: xhr kpk phx mcd
dvl: gnv kdh nhv
xfq: bjn
zzk: kvz cft pcp xvs
nhg: nzf vbl skv
sdh: mbj nvf nsn hxc
ftr: hxh rlz
ttd: jhg
bqp: jxm cqm
fch: fvh jhg
xkq: fnx tdk hfh
kgc: kfq
bnz: gng xqh psh fqp qrz
lbl: lkx cql hlf fdg
kxv: jdr ztl kpq
tpp: lqg
zcc: vth rbj bbt
hfk: vkg
gjk: bhf pnx dkb cfg
lhc: php vsm vns rkm
mgk: zgh lcb ttd
btz: glt qtm tjq
lsj: jxg
gnx: gss
btf: tnn pqq nnn kdz
lsr: gfh stk
vlz: rrx nrf ghb fqf
knc: skb vds hcm lzh bhf
lvq: mnv
fst: ptn gbp
nrf: blb khm bsx
jdj: fbb ttm dnn
jcm: pkp xqf lzd kfz nsf
rqz: qmr
blr: hcx
ngk: zgm mvh hxh
jxf: dvr mnc lzh tfv
lvh: tfv rvf jfk
fpf: rdj jgx
qfh: mvt jxf ssn pnb
ttm: ntc fvc qct
xld: llq hml lfp hbp
sld: lgj vck rqz rvg
bcr: lmf ggb hfh vkv
ccf: sth
xff: xlz ntg
jsh: qhz kqm nxs
mbj: lqg
xnr: spl
khv: sfc
zxx: zfc fzl fqp csp
nnl: txn pvg gdt
shh: frp sfj xcd pqx
mhm: lss dzb ntt mkn
hqf: bbm fmv sbd
htr: fdl jzv
qgg: mfn
cxt: nsk rts pqh kgp
shj: skl tpt pxl
pdl: lmg fjt fdl
ssh: gsg
bjd: rtt zmv fqp
rjp: lgk pmr kgp brj
tqc: rxq
xjv: xdh hpd fts bnv
htb: brz jdl sqh
qht: hxq xjj
rbt: zmv vmb nhx
clm: nsf dzx cbb jsh
scx: cqq
nhp: grl spj
hrk: lfd jck
tmk: nvf gmn
blg: fzl vpp
vnt: bfb
vrn: xvt kpp sfj xpd
vlt: hpd kcq qlq
gtt: lcs rfx
kpx: gjb zvq ztq vtj snb
rcj: dqm
hkc: lrc chr pkk rkx
csk: jnk bgh
vmb: hfh
qck: dkb mvh hmp
kzx: rlq vfv mhm gbn pqz vqp
lpm: jsh zzf
jlz: tbc tbd
sdq: nmk rfj pbb pqh
rtv: zlf tjc cql
phx: ghz cdg
qmk: gtf lqp ssn
zqt: cfp tdf phj
dsz: bnf lxv gbf scg
spn: qvq mgh pcx
vns: spl xdl xlx
mln: pfq xpq csk gpp kfq
xvs: hpv
nrd: fgn xnl bdt kzg
kpg: dzp khv
kvp: qtl
nsg: sbz qjg qbg ffq
ktj: bst fzf nvg xdf zhx
xkn: rtt xpd pmz jpq vkb
jgx: qkl
phk: kqj nzj zqt hzs
jdh: bfn pdh bjf zgh
lkj: ptv zkm
kkf: bjr
npk: pkr
jns: grl hmh nlg
dpt: qhc jxv llf cft
mvq: nqc
dqf: hpv ckl
tdt: ntl mbr nsn kvl
thj: lbh zrg qhh
vmg: pzb vds
zbk: jgr sch
kjs: gpx sbz rbg qcn
jvn: ktm cps ckk mcs
fbf: qfs dmb
sbp: vmm krx smp kzl
xpg: qcx jjg cqq fdl
bsh: lpk vjs qhl
xmc: nqc msg
jhl: gzk mjg dzf hpx
vlh: cmj
drl: dsh
xlk: flc vqp tsg sbz cqq
gbf: mfv jvh
mkn: cps
njs: hqf hkn cqq mdj
dcd: jpk lmg gpx
mdv: bnn jrc dbb
vsb: znq pkb dkb
mbr: tsg dnm tgj
zsx: gbf crz hlx rlh
kzg: bjf hpl
pxb: bst
fmk: mmt hjb mbg tbc
xcx: ccf
cmh: qqz jzf zbq
qnc: bsl bhf ftr scx
qts: fng nth fdx dmb
gml: dqk mdj ntt
qdm: vtj fdj mxs jzc
jrr: msr flg ptl knz vsn
lqp: skb ddg
khk: fsq skm jhg hmv
mgl: sdf
sbz: nmq
shm: snc grl tgx brj
vmp: qtl lsj
zfc: bjs dnn vfj vzd
dfm: qjb pqx mkf nkm dfq jkd
fgb: ggq qsm nsf nxd
ncr: sgl hzp jtb tgj
gss: kzc
mdl: sxm
kqj: jck
rhs: ghb tbc tbl snr
fkn: tjc fxl hbg
rqt: kfg
kvd: dcm qlc xvv mhg xrz
vrt: krb cqn cqj thx
jbc: lcc nmd cft lqt
hjb: mjk bfb pcp
rfp: jsl bjt
cxb: tks htr mkn
nrn: rqt txn pqq
jjg: cdr cff
mfv: tlp
dvd: xnv xqh jnp dzh
kvl: gjk vgn sxz
nrh: tmk xmk flc gbn
pnh: fpf nlf xtb
ctm: tzn gjn ccn
spg: bsl ckc zdc nvv
qzz: qhc gsg jkd qrl pzp ggm
jnz: kqj qjg
kqm: vdm jbp
qzg: rkm lvq ggq
vmm: fqq gdt
vsc: hkr vkb qrl
dsh: knz vfj
drt: vpp khv jhv
ltg: nnn
cfl: zvs fjk dxf xcf
mtn: ntx cfn
gtz: vml krb bms
jhv: hxl
pfr: cmj mhx lvh
zgh: zzl
xnb: sth thg
vhz: rrz kgx hcz pjs
sgl: gpl nvp zgm
pbk: kfx
rdr: tsb cdr bch
rlz: hzd kcx dpr kfz
mpg: rls fdj
qzh: spb cqq pqn
qsj: lgk
kzl: mcr nmq
nlj: csk spv
hht: ptv szl
xbz: jjj blg
lft: szp
lgj: kfz
hpx: cqr mhq
ktm: vgs
fng: ssj hfv bnf
pss: vsc bpg zmv msn
pkp: nvv
hfv: gng mgj
dkt: vzd
rqk: lgk
nmk: tbd
spb: mks
zkp: mbg msr
svq: jfk kxv jjr nfk tpt
dxg: pfd csz bjj zgh
fnh: hxc bdx bnv xfd
pfs: gsj rlm rnf lcb mgl
dbb: rxs dmb
hfp: qjb
dbc: cll cmj xdl fmf
rkm: nph kqd
krb: mvc
xcd: flq pqx
ztd: gvr
nkm: ttq ftv
dfs: spl vsv gnx nlf
dqk: mnc lzd cml
ccz: fqf csp qlc
dsl: nml nxd bkf qbg
smz: fcq qzn hrt
vsn: lcb nlg lpk
gqs: mtn hlf dzh bpq sqs
zlf: vsz ttm nlj
gqt: dzf ntt
xzp: qsj hxl fqf jfj
nzg: ngc
lph: snr jzc llt
rng: sgr kfz
ngd: tlp fqf
crx: spj zhf vth qvq bpq
fdr: dtj ghk pbb
fdj: ghk hlx
kgx: mmt gnc
pfq: zlx hkr ght ngd
cgk: dtp npk
kgd: pfd rnf
klz: rcj mcs fjt
jnp: xcf fbf
frb: hlx fhl lbl ffk
vck: pvg
pkn: smh mdl
rjb: gcl sdb hcx
spv: zfh nnd ckl nrc
lrc: bsx tfd qsq
vkx: frm gjb
lmk: klh zqt scp
fzt: zcq hgj dmz gbt gzc xdh kfg
hcr: kpp rsv nfp ggm dmr
qlv: lrr kmq nvf dms
jpp: hbp vfr
tks: lvc rtk
lbm: rht llq
vnz: dpz
jxr: dcm zfr hpv tbc ftv
rqm: csp gvn bbn rtt
hvl: cqn hrk nnl
plc: brt
bmb: dfq ckl
dzl: fqz dzp tpr
xhz: kmd xcd
jkd: npm
hmr: jtf ght xds gfr
fpv: qqz cbb shj cxb
gmz: kfx rlh rbj hpv
dgt: lhh tdk rdc
psm: rzg qdh khb drl
lqt: jpn fxl
tfv: fvv
ngc: hcx
kbd: pcx phd