itg: wvf rvk
edd: axa
feu: fdq ilp zkh
skm: otb wsh
qdc: bpy zyd
tuc: dxw ghp ptu
hnm: kuc iyh
wtb: ene ooc suc
qqg: tbl
blo: fpa wfs
sbc: jyk
zob: you fpa
wuf: ptu dxw
gfu: byw nvl
rhd: jpi
jqh: fgi nmy esk ibv
jpc: zpo rxr anc ocu pjz
zpo: cbq fft
pen: unr ekf
nca: xuo jur cwn
tzp: unr
spt: eaz
jpi: jnn fjt bmr
zan: tcv bbl lir kmw
dqp: ivl aip
zim: otb wsh
ebe: rcc jur
dvb: wjx bxb rbr rwi
bac: wch eaz
lpg: nap vya lfh ynf
gxw: shb gwg cnc ajz jjw
qzo: kzu kxu nzd wmr izs vmz hnm lwu qgm ggg qpi qub nvb ebe gxw
bov: yjs jes
bso: qzo kpd
wmr: puc bhd enr
xsm: ctd
zvl: out
yat: rhd
jzi: fit
xsr: gfu
dcp: jgw xme
bob: qlk hit hmh zan wvu
sel: deu kpd qzo xcb
kzu: puc
dxv: nss ugn ekw wwd
yyj: nbi knu woa
gid: lea
dbm: hit zan
ctd: blo cpg sdd
egl: out
hdd: wfs
hgk: bob dbm
qsq: mze tvu
qlk: bbl zvl kmw
qgm: xuo jur rcc
ypq: wai ayr lam
ekf: uqw lph ant
hkq: kpd tbl deu
jho: uug wgn
nbi: epy cuv lho swp
otd: out
gig: yog otb
prm: wxg
ilx: nzr
kup: wfs fpa
ont: qvl atz xvn
vmz: gwg cnc ajz
cnc: mpp gdr
zkh: lxz woi wuf gpa
sim: fhu gzi
jtr: ouh skz ijr
xgx: zeb mrr
cin: ooh edd xcp hea
cox: dhy
lir: out
grg: lvb
kea: ile
jjw: zjx
pjz: ibs fft
pgw: blj rmf qef msn yul
odo: you fpa
xtv: kpd qzo
bxy: fgi nmy ibv
svr: wjw utt etz ftn
jvs: cuv epy
ftn: feu xsr gxt gyn dvb xpe eyy nsj vtl zag vjw myh udz ojn zgz
eaz: nzr zso scj
yry: hzn
kcb: nmn kwe dyx phm
kuc: ooc suc
hvd: byk
uzt: exn
qio: lam pen tzp wai
wew: you fpa
mdk: zob nga
knu: epy cuv lxa
nap: yog wsh
jns: pen
eex: zti ivm
gxt: ilp fdq zkh
uxm: fda xqv gid
tyc: wsh yog
rcj: cpg
gal: hnp xme
viu: yrc toy
lam: unr
fvl: vpr xxk
bvv: out
wxg: lhu odo ueg
qda: fcd zxh yfk vej
nmd: nss ugn cey wwd
gyn: wjx bvs bxb
ake: ubk
skz: hnb zxj
smu: rvk wvf
dhy: ghp ptu
tvu: imt dac
avx: kea rbi
fsj: uvh nvl cuu byw
nkn: mze
vyo: ouh ijr
dyx: xcb qzo kpd deu
epn: svi
ave: scm kns xtv fih
ovq: bpy zyd lpg
hmh: zvl lir
ggg: ajz
qpi: kuc wtb iae iyh
mvf: xni
lkt: woa nbi
vxw: qxs ont
izs: qdc
yrc: mrr ivl aip zeb
zrh: uxm bzc vue
mfe: jyt rhd
vue: fda hbx wxq gid
nyf: tvr rgb hai
kpd: lwu izs ebe vmz nvb qub kxu nca qgm
zti: jhh
mze: imt dac
xhf: you
dbn: rzd ycr nyf oxf
ufs: hea
zsn: wai
ooc: ljt
qeb: wsh yog otb
kpz: kpo tlp ave
hje: xqv fda hbx gid
ene: dpi mud ljt
ljt: yog otb
cpg: you fpa wfs
swp: osd zlh gal
phe: ffh liv mnn
xme: gmx
plw: ghp dxw
ite: qoq dxw ptu ghp
iae: suc ooc
lha: bob
lea: lvb xqa
xni: oek kgh dyq cqy bek max nyx yat sph ufs mfe
rbr: ite
ibs: pxh lkl jho uiz
wsv: lha hgk
fhu: out
vxz: bmr ksi xxp jnn fjt
zfg: wvu zan hit qlk
qew: ake kdi hrj
yyh: ibv qda esk nmy fgi
vtl: fsj udj
sbb: out
ugn: xni wgn
jyt: otm vxz zbk
mzy: dxw
efd: tlp
qub: qdc ovq ofi
xpe: rwi bxb bvs
cuu: ghp dxw
toy: zeb mrr ivl dbn aip
cdz: hbx gid
epy: zlh
zou: wsh
urv: txq svi
qoq: fzh moy smu nbs cea rej tyx rjg epn jpc aol ukr itg hkh yzg urv jyf
moy: wvf
alr: ocu zpo
deu: nvb ebe qgm nca ggg hnm lwu wmr izs vmz nzd kxu
sdd: wfs
woi: qoq ghp dxw
zyd: ynf lfh zim
rej: rvk wvf tuo
gpm: kpd tbl qzo xcb
fit: uxm vue hje
rxr: fft ibs
aab: out
sti: gpm mlz
bln: uqo ant lph
avt: igm huk zhg
vjw: dao
sgk: wsh
zeb: oxf
ukk: gzi fhu yxi
atz: xni uug wgn
mls: uug
byk: nss cey
qez: kiu tuc
czf: jvs
jnn: qsz jlf
xha: deu tbl qzo xcb
ant: xhh lao see
rje: hgk lha ibu
rjg: fcw sxs
fcw: xvj
mci: wfs
zju: qhu ueh bah dpf mls
aol: vxw pxa fcw sxs
ouh: avt iqs
rzl: kpz jhh
dxw: cea yzg rej alr jyf jpc rjg fzh hvd aol ukr
hul: rcj
eeb: xxk vpr
vyq: dvt jyk
nvb: kuc wtb
zok: out
niw: otd bvv egl bdw
oxz: sti
anc: cbq ibs
yjs: grj oks jiw kup
dvt: uin
cob: ptu ghp qoq
fft: pxh lkl jho
ynf: wsh yog otb
xkd: wva kdi
txo: xht
jgw: aab bcf gmx
wfs: uzt vyo jns txo ypq zhk ngn jzi
mjm: kby
nvl: qoq dxw
hrj: mjm ubk mdk
pxa: ont xvj qxs gfw
ooh: gnh hkq bso qqg
gds: wfs
aip: dom rzd oxf
gpa: qoq
jur: ijn
mzx: mlz gpm sel
rbi: ile
gsq: otb yog
oek: yry rzl sve zti
rgt: vxz zbk
wgn: uot mgy dyq eex ufs wwt yat cin bit weh jji kgh oek
bit: jyt rgt rhd
kgh: rhd
gks: zoh eaz xwb
zxh: xhf fbb gns
yxx: ckk jaq
pot: sel ndw gpm
mnn: oxz vpr
bmr: jlf
xht: ibu lha hgk
zso: wsh
ekw: wgn uug xni
ksi: qsz
gwg: mpp zjx
cqy: zti
lxa: zlh afs
ayr: bln
jhh: spj ave
wai: ekf
bvs: cob
jyf: vxw
zag: fts
ivm: efd jhh kpz
hit: tcv lir kmw
nxw: yxx uas mte
grj: you fpa
ajz: mpp zjx gdr
jot: uug xni wgn
xcb: wmr nvb nzd hnm
bah: uug xni wgn
zoh: gig scj
scm: qzo tbl deu
dom: qfg niw tvr
ugx: lvb xqa mqd sfx
wwt: hea xcp ooh edd
fcd: gns fbb gds
ndw: xcb deu kpd tbl qzo
uqo: xhh lao see
nzr: yog otb
uot: hsw zll kcb
jiw: you fpa wfs
uas: ckk cox jaq
lvb: out
mrr: ycr
gpt: yrs mte wsu uas
exn: vue cdz uxm
dse: jes yjs hhk
evg: yjs
hea: qqg gnh axa
huk: sim
qsz: xcb kpd deu qzo
iyh: ene suc
gts: woa knu jvs nbi
fda: bck lea ugx vru
lfh: otb
blk: xev
ghp: cea fzh moy smu hkh yzg urv jyf aol tyx jpc rjg epn ukr
ivl: nyf
uug: nyx yat mgy uot jji jin oek kgh phe
mok: gds
gmx: out
xcp: bso hkq gnh
xev: hul fns
wvf: mvf fke cof
fgi: yfk zxh mok vej
bcf: out
sfx: out
dhv: azq ouh ijr skz
ibv: mok
qls: lgp kwe
tbl: kxu kzu lwu hnm vmz wmr qpi qub ggg nca qgm gxw ebe nvb
kiu: dxw ghp
wxb: tbl xcb
sve: kpz jhh duv efd
ocu: cbq fft
bek: edd ooh azo xcp
tcv: out
wch: zso nzr scj gig
zhg: qgu ukk
bxb: ite cob
obg: wva
fjt: xha jlf qsz
kpo: xtv fih wxb kns scm
oks: wfs you
lhu: fpa you
jgh: rje xht wsv
zbk: ksi xxp
xvj: atz gmd qvl
qvl: wgn
uiz: xni wgn
wsu: jaq
txq: mls qhu ueh bah dpf
sxs: gfw ont
xqa: out
rwi: cob plw
ilp: wuf lxz
cuv: osd
szw: ghp dxw qoq
duv: ave tlp spj
xwb: gig scj nzr tyc zso
suc: ljt mud dpi
ojn: dao nxw
jaq: szw mzy pdm dhy
gfw: atz gmd qvl
oxf: hai qfg tvr
qfg: kie
ckk: zke szw pdm
cea: vxw pxa
ofi: zyd bpy
ile: qoq ghp
mte: ckk
dpf: xni uug
qxs: qvl xvn gmd
nbs: vxw fcw
wxq: ugx
yxi: out
uvh: ptu
wvu: bbl lir
jkw: wsh otb yog
mlz: qzo deu tbl kpd
yrs: cox ckk
weh: kcb zll
igt: mze tvu
ibi: you fpa wfs
uin: rfo ctd
svi: ueh bah qhu
rfo: cpg blo sdd
pke: qef blj
shb: zjx mpp
rgb: bdw otd egl
fke: wgn
qug: sim ukk
tyx: txq zju svi
gip: yyh
ptz: prm tvu
zhk: dqp toy xgx yrc
hbx: bck
uqw: see xhh
iff: ekw nss cey
eyy: udj fsj
ycr: hai qfg tvr
fts: ile kiu tuc
dyq: qls zll
bdw: out
ovj: syq sel
cvg: fdq ilp
yxl: jqh
uvg: hrj ake kdi
nss: uug
kie: out
cbd: fss jqh bxy
gpy: zoh wch ilx
jyk: qeo hul fns xsm uin
qef: hvb urg
lxz: qoq ghp dxw
xqv: grg bck
esf: ptu
xfo: mlz ndw
kmw: out
xxp: xha
lbq: rmf blj msn yul
mud: wsh yog otb
bbl: out
tvr: kie egl
sbf: rmf blj
fih: deu
wav: hrj ake kdi
xuo: gsq sgk
wwd: wgn
urb: exn fit zrh
yni: yyh bxy
byw: dxw ghp
cbq: jho jot uiz lkl
zjx: pud skm
hzn: kpo ave tlp
tlp: scm kns wxb fih xtv
jin: kcb zll
iah: ukk qgu
ijr: iqs zxj hnb
hvb: hdd ibi
hhk: oks grj kup jiw
tuo: cof fke
nsj: qez rbi
scj: wsh yog
bpy: vya ynf lfh
yog: nkn evg pke okc cbd uvg sbf xkd bov yxl lbq wav
reh: uas
syq: xcb
wyt: exn zrh
afs: hnp
esk: vej yfk zxh fcd
edj: ibi hdd ate trg
vej: xhf
ifb: fpa you wfs
fss: qda ibv
vpr: sti ovj xfo pot
hsw: phm dyx kwe nmn
kns: qzo tbl kpd
mgy: kcb
yfk: gds fbb gns ifb
sph: yry
ptu: fzh cea nbs rej rjg jpc tyx aol yzg hkh jyf urv
lho: dcp gal afs osd
cey: wgn
blj: hvb
wpt: ilx
udj: cuu uvh byw esf
myh: zkh ilp
zll: dyx nmn
azo: hkq qqg bso
iqs: igm qug huk iah
jic: kby qdo
ffh: oxz vpr
ytx: you fpa
qhu: wgn
liv: xxk
nmn: kpd tbl
ubk: kby nga
jji: sve rzl zti yry
yul: txg hvb urg edj
wva: mjm eep
igm: sim
vru: sfx xqa
vya: wsh yog
umj: fss bxy jqh
mqd: out
dac: lhu odo ueg doc
ijn: yog
you: dhv yyj viu urb czf jns ngn gts jtr zsn
see: sbb wkm
fns: rfo
axa: xcb deu tbl kpd
fzh: ocu pjz anc rxr
bck: sfx
pxh: wgn xni
hkh: nmd
lgp: tbl deu
hnp: aab bcf
fbb: wfs
enr: gks bac gpy spt
unr: uqo ant lph uqw
woa: lxa lho cuv swp epy
hai: otd bdw
yuh: hhk yjs
ate: fpa
okc: mze
azq: zxj hnb iqs avt
pdm: ghp dxw ptu
hnb: huk qug igm iah
jlf: qzo kpd deu xcb
bzc: gid wxq hbx
otm: ksi bmr
lwu: enr puc
zlh: jgw hnp xme
gzi: out
pud: yog
cwn: zou
fdq: woi gpa
wjw: cvg avx kzo gyn gxt dvb eyy xpe nsj ttx ojn udz vjw myh zgz qiv
zke: ptu ghp dxw qoq
gmd: xni uug
ueh: wgn uug
trg: you wfs
mpp: skm
txg: trg ate ibi
qdo: wfs
nga: fpa you
utt: qiv zgz myh udz ojn xpe eyy dvb zag gxt xsr kzo avx
nmy: yfk vej
cof: uug xni wgn
max: ffh eeb liv fvl
wjx: cob
ttx: reh dao
gns: wfs you fpa
xvn: wgn uug
xxk: sti ovj mzx
zxj: huk igm
lkl: wgn uug
puc: gpy bac wpt
osd: jgw hnp
dao: yrs mte wsu yxx
etz: vtl eyy ojn cvg vjw gyn kzo
ukr: zju
kwe: qzo xcb
kzo: bxb rbr wjx bvs
gnh: tbl deu xcb
kxu: ajz cnc jjw shb gwg
spj: kns wxb scm
wkm: out
doc: wfs fpa
bhd: wpt spt gpy
kdi: jic mjm
ibu: dbm zfg bob
imt: ueg ytx lhu odo
nzd: ovq
gad: ayr
qgu: gzi yxi fhu
lao: wkm sbb
ueg: you
jes: kup wew grj
ulh: yjs hhk
yzg: dxv byk iff
rmf: txg urg edj
rvk: fke
fpa: nbx jgh lkt yyj viu urb ypq txo wyt gad jns ngn gts jtr qio zsn dhv uzt czf
zgz: gpt
qeo: ctd rfo
ngn: dqp yrc xgx
qiv: rbr bxb
phm: tbl kpd deu xcb
eep: kby qdo nga
gdr: qeb skm
nbx: xht rje
otb: gip xkd wav qew yuh igt ptz obg umj qsq sbc dse vyq pgw uvg
nyx: fvl mnn ffh
xhh: zok sbb
dpi: yog
wsh: obg qsq uvg sbc evg dse pke vyq yxl wav sbf xkd yni qew ulh ptz nkn umj igt cbd pgw okc lbq gip bov yuh blk
kby: you
rcc: jkw ijn gsq sgk
rzd: tvr qfg niw
urg: mci
udz: kea
msn: txg hvb urg
lph: lao